*************************
*   ##    #####    ##  B*
*   ##     ###     ##   *
*   ##             ##   *
*   ##    **#**    ##   *
*          * *          *
*###       * *       ###*
*###       * *       ###*
*          * *          *
*          *#*          *
*#  *     #####     *  #*
*## ******#####****** ##*
*## #    #######    # ##*
*## ******#####****** ##*
*#  *     #*#*#     *  #*
*          * *          *
*          * *          *
*###       * *       ###*
*###       * *       ###*
*         **#**         *
*   ##             ##   *
*   ##     ###     ##   *
*H A##    #####    ##   *
*************************
