*************************
*                       *
*                       *
*                       *
*                       *
*  #######              *
*  A #                  *
*    #                  *
*    #                  *
*    ##############     *
*    #     #      #     *
*    #                  *
*    #                  *
*##########     ####### *
*                       *
*                 B     *
*  ##########           *
*                       *
*                       *
*                       *
*                       *
*          ***          *
*          * *          *
*************************
