*************************
*                       *
*  ##  #  ## ##  #  ##  *
*  ##  #  ##B##  #  ##  *
*  ##  #  ##*##  #  ##  *
*  ##  #  ##*##  #  ##  *
*  ##  #  ## ##  #  ##  *
*  ##  #  ## ##  #  ##  *
*                       *
*         ## ##         *
*                       *
*    ###         ###    *
**                     **
*    ###         ###    *
*                       *
*                       *
*         ## ##         *
*         #####         *
*  ##  #  ## ##  #  ##  *
*  ##  #  ## ##  #  ##  *
*  ##  #         #  ##  *
*  ##  #   ###   #  ##  *
*          #A#          *
*************************